111111111111111
100022220202021
101010101012101
122002020220001
101210121010121
120200220202021
101010121210121
120000220022221
101210121212121
100022222002201
101010101212101
122220020000001
111111111111111