111111111111111
102000200000201
121012101210101
120000222002001
101010121010121
100200020002001
121010101210121
120220000000021
101010121210121
122200220202021
101010121010101
100200002222001
111111111111111